and - ma
or - obu
True - ezi
False - asi
None - odighi
def - kowa
class - udi ihe
self - onwe
global - uwa
from - site
import - bubata
as - dika
return - laghachi
pass - gafere
raise - bulie
continue - gaa nihu
if - oburu
elif - oburu na
else - ozo
for - maka
in - nime
not in - obughi nime
while - mgbe
break - kwusi
try - nwa le
except - wezuga
finally - nikpaazu
assert - ikwuputa
exec - exek
lambda - lamuda
print - deputa
with - na
yield - meputa
input - ntinye
str - stl
bool - bool
list - ndeputa
dict - dicti
tuple - tupul
set - seti
frozenset - frozenseti
chr - chl
ord - ord
file - failu
int - int
float - float
complex - complexi
hex - hex
abs - abs
cmp - cmp
startswith - malitena
endswith - mechiena
join - sonye
split - Kewaa
replace - dochie
encoding - enkoodu
decoding - dekoodu
append - gbakwunye
extend - gbatia
insert - tinye
pop - tufuo
next - nkeozo
remove - wepu
reverse - tugharia
count - guo
index - onodu
sort - hazie
keys - igodo
values - uru
items - ihe
update - melite
copy - dere
clear - anyado
add - gbako
discard - tufuoya
union - njiko
intersection - nrutu
difference - odiiche
symmetric_difference - symmetric_difference
open - meghe
read - guba
write - dee
readline - guo ahiri
readlines - guoo ahiri
close - mechie
callable - callable
dir - dir
getattr - inweattr
hasattr - iheattr
setattr - setiattr
property - onwunwe
len - lenz
max - kacha elu
min - kacha ala
enumerate - kowaa
eval - le ma kowa
filter - yochaa
map - maapu
range - usoro onu ogugu
xrange - xrenji
sum - chikota
type - udi
object - ihea
zip - kekota
help - nyeaka
locals - obodo
globals - uwaa
classmethod - usoroklass
Exception - Naani
Error - Mmejo
ArithmeticError - MmejoAlithmetic
AssertionError - MmejoAssertion
AttributeError - MmejoAttribute
DeprecationWarning - NdumoduDeprecation
EOFError - MmejoEO
EnvironmentError - MmejoEnvironment
FloatingPointError - MmejoFloatingPoint
IOError - MmejoIO
ImportError - MmejoIbubata
IndentationError - MmejoIndentation
IndexError - MmejoIndex
KeyError - MmejoKii
KeyboardInterrupt - KiiboardIntellupt
LookupError - MmejoLookup
MemoryError - MmejoMemory
NameError - MmejoAha
NotImplemented - AdighiImplemented
NotImplementedError - MmejoAdighiImplemented
OSError - MmejoOS
OverflowError - MmejoOverflow
OverflowWarning - NdumoduOverflow
ReferenceError - MmejoReference
RuntimeError - MmejoRuntime
RuntimeWarning - NdumoduRuntime
StandardError - MmejoStandard
StopIteration - KwusiIteration
SyntaxError - MmejoSyntax
SyntaxWarning - NdumoduSyntax
SystemError - MmejoSystem
SystemExit - SystemEgzit
TypeError - MmejoType
TabError - MmejoTab
UnboundLocalError - MmejoUnboundLocal
UnicodeError - MmejoUnicode
UserWarning - NdumoduUser
ValueError - MmejoValue
Warning - ido aka na nti
WindowsError - MmejoWindows
ZeroDivisionError - MmejoZeroDivision
UnicodeDecodeError - MmejoUnicodeDecode
